A . . # . . .
. # . . . # .
. # # # . # .
. . . . . # .
# # . # . . B